11111111
11111111
11222222
00000222
00000222
00000000

Mud
Jungle
Water