000000000000000
000000000010000
000100000111000
001110001111100
011111011111110

Outside
Inside